爱哭鼻の阿木木	丐帮
怒怒怒怒火	唐门
诸天花雨	天香
墨韵轩华	太白
池小晚	天香
太极至尊	真武
一个有内涵的人	神威
机智勇敢的小炮	丐帮
亲爱的未闻花名	天香
倾舞情儿	天香
蚩尤魔人	神威
她心屿	太白
北凉老妖	天香
意邪	丐帮
君挽言	天香
久成病	太白
丶初馨	神威
花间绕柔指丶	神威
不灭死神	真武
武藏野剑太	太白
东北枭雄赵本山	神威
帝君虹	丐帮
这货不是刘鑫雨	丐帮
孤影惊残梦	唐门
纳兰柔弱	真武
倚楼听風	真武
慕容飞羽	神威
裴述	天香
唐雪棠	唐门
南眸	天香
桜染	神威
一曲月霜寒	五毒
泪成殇	神威
约德尔人兯	太白
艾尔艾路弗	天香
咸鱼天香	天香
小卤蛋丶	天香
顾輕	天香
丨寻她丶丨	真武
我一直没有曾经	丐帮
雪域星空	天香
影流皇族	唐门
寒抹	真武
大岛遥香	天香
凱蒂喵	五毒
姬如影	唐门
回忆不曾悲伤	太白
不疯魔不可活	丐帮
棒棒噠	神威
任离流	太白
小叮咚姣姣	丐帮
°°	五毒
凡人的梦	真武
旧人谙	太白
ParTing丶X	丐帮
方得始終	太白
千雪冰鳳	天香
友善的白菜棒子	天香
潇懿风	丐帮
红毛	真武
唐葫芦呀	唐门
仁剑震音扬	真武
茗爷	神威
永恒只为等待	神威
云紫婳	天香
嗯哼丶一刀	五毒
氹萌萌	太白
放肆流逝的年华	唐门
墨雨丶晓枫	太白
杂粮煎饼	天香
文大飞	神威
最喜欢你了	五毒
清弦	唐门
似有若无	真武
归海异道	五毒
魅影灬冥月	真武
丿几度度丶	神威
简单愛	神威
闻素问	天香
Puppet丶半心人	唐门
琴若璃	天香
kingdan	唐门
利念晴	天香
剑泣天涯	太白
长河的水儿不浑	神威
南宫元	太白
雪糕失望	太白
离殇天丶	丐帮
云紫涵	真武
阿锟猫	天香
画芊骨	天香
流韵丶	丐帮
翁瑞婷	真武
火之鸟	真武
反正我是最小的	天香
女神绘梨衣	真武
笛梦一秋	天香
椛灯	天香
移星	神威
阡小陌	太白
七贱丶下天山	唐门
唐糖～	神威
芙蕖笙歌	唐门
夜半月微凉	神威
有马薰	天香
風云	真武
洛枳丶	五毒
魅丿无情	真武
涛声依旧彡	真武
辉哥哥	唐门
随你几时丶	丐帮
轻笑忘	真武
楪夢	神威
会跳舞的熊宝宝	五毒
江玉静	真武
唯声丶丶	五毒
月华司	神威
一将羽霄一	丐帮
红颜痴情笑	真武
董汉卿	唐门
就叫玫瑰吧	真武
绑定小蜜的	天香
ParTing丶R	天香
い楓ゞ妖い	丐帮
慕容媚	真武
思念永远美好	天香
我是恺子爸	丐帮
坐下来慢慢谈	神威
刃歌	太白
君i陌离	五毒
棠无双	唐门
初墨凝	太白
冬凝寒	真武
凡哥的父亲	真武
碧空沧海藏云山	五毒
夜袭寡妇寨	五毒
天韵ゝ	丐帮
明天不见	太白
倾国不倾城	天香
手中玫瑰赠予谁	五毒
黒无常	太白
万心忧	真武
偏不	丐帮